11111111111
1P000010001
1C000010001
1E010000111
10010000111
11111111111
